#################################################
#..#........#...........#.......................#
#..#.......................................##...#
#..######.##########.#########........#....##...#
#..#..................................#.........#
#..#....##.......##.............##....#######...#
#...............................##..............#
#..##.############.###########........#######...#
#..###..........................................#
#..#######.#############.#####....###.......##..#
#...............................................#
#################################################